.@.....#.#######...#
##@.#.#.##.#..#####.
@..#.#....###..##..#
@##..##..#..#.##.###
.##@..#####.#.#.....
@....#....#....#....
@#..####.##.#.......
@##.....#.#.#.#...##
.#@..#.###.#...#....
.#@.#.#.##.#.#..#.#.
##@.###.###.#.#..#..
..@#.##..##...#.#...
##@.#.....###.##..#.
@.##..#####..#...###
