#@#..##...##.##.#.##
##@....#...##.#.#.#.
@.###...####.#...###
@..#.....#.#.##..##.
.@#.##...##.###.#.##
###.#.....#@####..##
.@#....#...#..#..###
..#.##.@##..#....###
@##....##..#.###.#.#
@#######.....#....#.
#.#@##..#.#..#.#.##.
@#...###.###.##.###.
#.##@#...#.#..#.#.#.
@....##....#.#.#.###
