.##...#.#..###.##.#.
....##.#..##..##...#
##.#.##..##..#.##...
##...#...##.#.#####.
#..##..####..##.#...
.##.###.#.#####....s
.#####.@.#...###..##
###.#.....#.#..z###z
.###.##.#z##....#...
##.###z####..z..#...
#....###.###c..#.#.#
..#.##.#.##.#.####..
##..#......#...####.
..##..##z.#.#.#..##.
