....#....##..##..#..
..#.#.#.####.#...#.#
.###.#...#.#.#..##.#
.####.#.#####.#....#
.#.#..####......##.#
.#.#z###@##..####.h.
#.#.#....z#..#..#.##
.....##.#######.#.#z
..#...#....####.####
..#.#...#.#####z....
#.#####..#######..##
..#.##..#...###.#..#
..#....#...#####.##.
#..c.###..#.#.#....#
