#......#...#......##
.###..#.#.###.....#.
.##.##.#.#.#....#.##
..#.#...###..###.##.
#.##.#.#.#####.#..##
#.#.#c.##...s##..##.
#####.##s.##...###..
.####.#..#...####..#
..####.#.###..##....
#.###..#.s.##.####.#
...####....#.#.z####
...#.#s###.##..##.##
.###.z.##.#.#.##z#..
#..##...#.......z...
###
###@
