###..#.....#.#..#...
#.#..#.#.#.###..##.#
#.###.##.##.#..#..#.
........##...##.##..
#...#..##.....#..#.#
#.#.#.#...#...#..###
..#...###..#..##.#.#
#.#....#.##.##.###..
..##....@...#####...
..###...###.#..##.##
#....###....##.#.#.#
##.#.###..#..##...#.
#.##...##......##.#.
..#.#.#.....#....#.#
