#....#####.#.#..#.#.
#..##.#...#.#.#.###.
.###z###...#....zh##
c#..#.##..#.@##.#.#.
#.#####..#.##.##.#..
#.#.##.#.#####.##...
#.#.#....##.##..#.#.
##.##.....z####...##
.###.#.###..#.#.....
##.#.##.##.#.z..##..
#.....##.##.########
.#.z####.##..#h.##.#
##.#.....#####.#.##.
......#.####.#.#.#.#
