####################
##.########z#####.##
######.#############
######.########.####
####..@..###########
######.######.######
#.####.#############
########.#z####.####
####################
######.########.####
###.#####z##########
##############.#####
##.#################
###############.####