..#.##.####.##..###.
####..###......#####
#...##..##.#..#...##
...##..#.#.#....#...
.#..#..#...#..##..##
....##.h########.#.#
###.####..######...z
...#.#..##.###.##...
#..#..####z.#.#.#.##
.....#..#.###.....#.
.#...###...###......
#.##..###....##....s
..#..##...#z#.#z.#..
##.##...###z#s#z#.#.
$$$
$@$
$$$
