..###...####.###.#.#
#..#.#.##.#..###..##
#..#.##...##.##..##.
.#.##.#######..##.#.
.##.#.##.##.###.#.##
...#.###...##.s.##..
#.#..##..#...z#..#..
#..#..#.#...#..z##.#
#...#.#.#......##.#.
.####.#.#s##.###.###
.....z.###.h##s##.#.
..###...#.#@s#...###
..#...####.##..#..##
.#.#..#....#.z..s.#.
